# -*- coding: utf-8 -*-
a	a
o	O
e	7
ai	aI^
ei	eI^
ao	AU^
ou	oU^
an	an
ang	AN
en	@n
eng	7N
ong	UN
u	u
ua	wa
uo	wO
uai	waI^
ui	weI^
uan	wan
uang	wAN
un	w@n
i	i
ia	ja
ie	jE
iao	jAU^
iu	joU^
ian	jEn
iang	jAN
in	in
ing	iN
iong	jUN
v	y
ve	H9
van	HEn
vn	yn